EEEEEEEEEEEEEEEEEEEE
SSSSSSSSSSSSSSSSSSSS
SSSSSSSSSSSSSSSSSSSS
SSSSSSSSSSSSSSSSSSSS
SSSSSSSSSSSSSSSSSSSS
SSSSSSSSSSSSSSSSSSSS
SSSSSSSSSSSSSSSSSSSS
SSSSSSSSSSSSSSSSSSSS
SSSSSSSSSSSSSSSSSSSS
SSSSSSSSSSSSSSSSSSSS
SSSSSSSSSSSSSSSSSSSS
SSSSSSSSSSSBSSSSSSSS
SSSSSSSSSSSSSSSSSSSS
SSSSSSSSSSSSSSSSSSSS
SSSSSSSSSSSSSSSSSSSS
SSSSSSSSSSSSSSSSSSSS
SSSSSSSSSSSSSSSSSSSS
SSSSSSSSSSSSSSSSSSSS
SSSSSSSSSSSSSSSSSSSS
SSSSSSSSSSSSSSSSSSSS