EEEEEEEEEEEEEEEEEEEE
EEEEEEEEEEEEEEEEEEEE
EESSSSSSSSSSSSSSSSEE
EESSSSSSSSSSSSSSSSEE
EESSSSSSSSSSSSSSSSEE
EESSSSSSSSSSSSSSSSEE
EESSSSSSSSSSSSSSSSEE
EESSSSSSSSSSSSSSSSEE
EEEEEEEEEEEEEEEEEEEE
EESSSSESSSSSEESSSSEE
EESSSSESSSSSEESSSSEE
EESSSSESSHSBEESSSSEE
EESSSSESSSSSEESSSSEE
EESSSSESSSSSEESSSSEE
EEEEEEEEEEEEEEEEEEEE
EESSSSSSSSSSSSSSSSEE
EESSSSSSSSSSSSSSSSEE
EESSSSSSSSSSSSSSSSEE
EEEEEEEEEEEEEEEEEEEE
EEEEEEEEEEEEEEEEEEEE