EEEEEEEEEEEEEEEEEEEEEEEEE
EEEEEEEEEEEEEEEEEEEEEEEEE
EEEEEEEEEEEEEEEEEEEEEEEEE
EEESSSSSSSSSSSSSSSSSSSEEE
EEESSSSSSSSSSSSSSSSSSSEEE
EEESSSSSSSSSSSSSSSSSSSEEE
EEESSSSSHSSSSSSSSSSSSSEEE
EEESSSSSSSSSSSSSSSSSSSEEE
EEESSSSSSSSSSSSSSSSSSSEEE
EEESSSSFSSSSSSSSSSSSSSEEE
EEESSSSSSSSSSSSSSSSSSSEEE
EEESSSSSSSSSBSSSSSSSSSEEE
EEESSSSSSSSSSSSSSSSSSSEEE
EEESSSSSSSSSSSSSSSSSSSEEE
EEESSSSSSSSSSSSSSSSSSSEEE
EEESSSSSSSSSSSSSSSSSSSEEE
EEESSSSSSSSSSSSSSSSSSSEEE
EEESSSSSSSSSSSSSSSSSSSEEE
EEESSSSSSSSSSSSSSSSSSSEEE
EEESSSSSSSSSSSSSSSSSSSEEE
EEESSSSSSSSSSSSSSSSSSSEEE
EEESSSSSSSSSSSSSSSSSSSEEE
EEEEEEEEEEEEEEEEEEEEEEEEE
EEEEEEEEEEEEEEEEEEEEEEEEE
EEEEEEEEEEEEEEEEEEEEEEEEE