SHOEESSSESSESSSOOOES
EOEEOOSSSSESESESSSSS
ESESSOEOOSESOSESSSOE
SSSSOOSSSSSSSSSESSSS
OSSSSSSOSSOSEESOOSOS
OEEOSOEOSESOSOSSOSES
ESSSEEOEEESESOOSOSOS
OSSEOESEOEOSESESSEES
OOSEOSSESOSOSEESSEES
SOSSEEOSSEOSSSOOSOOE
EEOOEOSSSSSESSESEOSS
OSEOSSSSEEOSSEEESOSS
SSSSSESEEOEOSEOSOOSS
OSESSEOSSSSSSOSSOEEE
OSSESSESSSEEOSOOSOES
EEOOEOOEESSESSOEOSOS
OSESSEESEESSOSOSSESS
SSSSSSSSSESSSSSOESOE
SSSSSSOEOOSSSOSEESSS
SSSOSSSSOOOSEESSSSSS